type octile
height 8
width 16
map
................
................
............@...
............@...
............@...
@@@@@@@@@@@@@...
............@...
................
